{
  "name": "MF34",
  "vendorProductId": 441667409,
  "macros": ["", "", "", "", "", "", "", "", "", "", "", "", "", "", "", ""],
  "layers": [
    [
      "KC_PAUS",
      "KC_SLCK",
      "KC_CALC",
      "KC_PSCR",
      "KC_VOLD",
      "KC_VOLU",
      "KC_MPLY",
      "TO(3)",
      "KC_HOME",
      "KC_PGUP",
      "KC_NLCK",
      "KC_PSLS",
      "KC_PAST",
      "KC_PMNS",
      "KC_DEL",
      "KC_END",
      "KC_PGDN",
      "KC_P7",
      "KC_P8",
      "KC_P9",
      "KC_NO",
      "KC_NO",
      "KC_NO",
      "KC_NO",
      "KC_P4",
      "KC_P5",
      "KC_P6",
      "KC_PPLS",
      "KC_NO",
      "KC_PEQL",
      "KC_NO",
      "KC_P1",
      "KC_P2",
      "KC_P3",
      "KC_NO",
      "KC_LBRC",
      "MO(1)",
      "KC_RBRC",
      "KC_NO",
      "KC_P0",
      "KC_PDOT",
      "KC_ENT"
    ],
    [
      "KC_TRNS",
      "MO(0)",
      "KC_TRNS",
      "KC_TRNS",
      "KC_TRNS",
      "KC_TRNS",
      "RESET",
      "RGB_TOG",
      "RGB_HUI",
      "RGB_MOD",
      "KC_TRNS",
      "KC_TRNS",
      "KC_TRNS",
      "KC_TRNS",
      "KC_TRNS",
      "RGB_HUD",
      "RGB_RMOD",
      "KC_TRNS",
      "KC_TRNS",
      "KC_TRNS",
      "KC_NO",
      "KC_NO",
      "KC_NO",
      "KC_NO",
      "KC_TRNS",
      "KC_TRNS",
      "KC_TRNS",
      "KC_TRNS",
      "KC_NO",
      "RGB_VAI",
      "KC_NO",
      "KC_TRNS",
      "KC_TRNS",
      "KC_TRNS",
      "KC_NO",
      "RGB_SPD",
      "RGB_VAD",
      "RGB_SPI",
      "KC_NO",
      "KC_TRNS",
      "KC_TRNS",
      "QK_CLEAR_EEPROM"
    ],
    [
      "KC_TRNS",
      "KC_TRNS",
      "KC_TRNS",
      "KC_TRNS",
      "KC_TRNS",
      "KC_TRNS",
      "KC_TRNS",
      "KC_TRNS",
      "KC_TRNS",
      "KC_TRNS",
      "KC_TRNS",
      "KC_TRNS",
      "KC_TRNS",
      "KC_TRNS",
      "KC_TRNS",
      "KC_TRNS",
      "KC_TRNS",
      "KC_TRNS",
      "KC_TRNS",
      "KC_TRNS",
      "KC_TRNS",
      "KC_TRNS",
      "KC_TRNS",
      "KC_TRNS",
      "KC_TRNS",
      "KC_TRNS",
      "KC_TRNS",
      "KC_TRNS",
      "KC_TRNS",
      "KC_TRNS",
      "KC_TRNS",
      "KC_TRNS",
      "KC_TRNS",
      "KC_TRNS",
      "KC_TRNS",
      "KC_TRNS",
      "KC_TRNS",
      "KC_TRNS",
      "KC_TRNS",
      "KC_TRNS",
      "KC_TRNS",
      "KC_TRNS"
    ],
    [
      "KC_TRNS",
      "KC_TRNS",
      "KC_TRNS",
      "KC_TRNS",
      "KC_TRNS",
      "KC_TRNS",
      "KC_TRNS",
      "KC_TRNS",
      "KC_TRNS",
      "KC_TRNS",
      "KC_TRNS",
      "KC_TRNS",
      "KC_TRNS",
      "KC_TRNS",
      "KC_TRNS",
      "KC_TRNS",
      "KC_TRNS",
      "KC_TRNS",
      "KC_TRNS",
      "KC_TRNS",
      "KC_TRNS",
      "KC_TRNS",
      "KC_TRNS",
      "KC_TRNS",
      "KC_TRNS",
      "KC_TRNS",
      "KC_TRNS",
      "KC_TRNS",
      "KC_TRNS",
      "KC_TRNS",
      "KC_TRNS",
      "KC_TRNS",
      "KC_TRNS",
      "KC_TRNS",
      "KC_TRNS",
      "KC_TRNS",
      "KC_TRNS",
      "KC_TRNS",
      "KC_TRNS",
      "KC_TRNS",
      "KC_TRNS",
      "KC_TRNS"
    ]
  ],
  "encoders": []
}